0000000000
0100000000
0100000000
0111111100
0000000000
0000400000